1111111
1001001
101E101
10P1001
1010001
100C001
1111111