1111111111
1001000001
101E100001
10P0000001
1011000001
100C100001
1111111111